R 500 500

NO textures/eagle.xpm
SO textures/bluestone.xpm
WE textures/wall_1.xpm
EA textures/wall_4.xpm

S textures/eagle.xpm
F 224,172,105
C 205,249,255

11111111111
10000000001
10000000001
10000000001
10000000001
10000000001
10000000001
11111111111
