R 500 500

NO textures/eagle.xpm
SO textures/bluestone.xpm
WE textures/wall_1.xpm
EA textures/wall_4.xpm

S textures/eagle.xpm
F 224,172,105
C 205,249,255

11111111111111111111111111111
10000000001100000000000000001
10110000011100000000000010001
10100000000000000000000100001
10110000011100000000000010001
10000000001100000111011110001
11110111111111011100000010001
11110111111111011101010000001
11000000110101011000000000001
10000000000000000000000000001
10000000000000001101010010001
11000000110101011111011110001
11110111111101011111011110001
11111111111111111111111111111